＃
＃　変数等の初期化。
＃　上書きしないので、途中追加した変数にも初期値を設定できます。
＃

＊初期化
＄喋り間隔	１８０秒
＄喋り間隔誤差	１０％
＄会話時サーフェス戻し	有効
＄デフォルトサーフェス0	0
＄デフォルトサーフェス1	10
＄スコープ切り換え時	\n[half]
＄ユーザ名	ユーザさん
＄自動挿入ウェイトの倍率	２００％
＄誕生月	０
＄誕生日	０
＄ユーザ誕生日フラグ	０
＄ユーザ性別	不明
＄ひとまろ親密度	0
＄にえ親密度	0
＄赤人親密度	0
＄みつね親密度	0
＄見切れ利用	OFF
＄重なり利用	OFF
＄喋り頻度	静か
＄更新	通常
＄季節トーク優先	しない
＄新規トーク優先	しない
＄選択肢回避	する
＄赤人初回	未
＄光音初回	未
＄酒カウント	０
＄赤人状態	通常
